S##.............................
..#.............................
...######.........##########....
........#..................#....
........#.................#.....
........#####.......######......
............#......#............
............#.......#...........
............#.......#...........
......#######.......#...........
......#.............#...........
......#..............###........
......#................#........
.......#...............#........
........#...............#.......
.........#.......#......#.......
.........#..............#.......
............#...........#.......
............#...#.......#.......
............#...#........#......
............#...#.........#.....
............#...#.........#.....
............#..........#........
............#..............#....
...##..#####....#..........#....
.#..............#...........#...
.#..............#...........#...
.#......#######............#....
.#.....#................#.......
.......#................#.......
..####.........#.....#..........
................######..........